AYY = "countries/AyyubidsME.txt"
AZE = "countries/Azerbaijan.txt"
BRL = "countries/Braelyc.txt"
CAU = "countries/Caucasia.txt"
CTH = "countries/Carthage.txt"
CYR = "countries/Cymru.txt"
DAG = "countries/Dagestan.txt"
EIR = "countries/Eire.txt"
EVK = "countries/EvenkFederation.txt"
FRC = "countries/Franconia.txt"
FRX = "countries/Francia.txt"
GRC = "countries/GranColombia.txt"
HBC = "countries/HudsonsBayCompany.txt"
HNS = "countries/UnitedHansa.txt"
JNG = "countries/Jingtai.txt"
JOS = "countries/Joseon.txt"
KCH = "countries/KoryakFederation.txt"
KRD = "countries/Kurdistan.txt"
LBA = "countries/Alba.txt"
LOM = "countries/Lombardy.txt"
MCC = "countries/Mecca.txt"
NGF = "countries/NorthGermanConfederation.txt"
PDB = "countries/Paderborn.txt"
REA = "countries/RomanAmerica.txt"
REI = "countries/RomanIndia.txt"
RHN = "countries/Rhineland.txt"
SGF = "countries/SouthGermanConfederation.txt"
SOE = "countries/Soest.txt"
SRE = "countries/SriEmas.txt"
SWA = "countries/Swabia.txt"
TRK = "countries/QirQoyunlu.txt"
TRN = "countries/Tatarstan.txt"
TTS = "countries/TheTwoSicilies.txt"
UKS = "countries/UnitedKingdoms.txt"
ZCV = "countries/Zapadoslavia.txt"